A&&&&B   &
     & & &
&& & & & &
&  &   & &
&& & &&& &
&        &
&&&&&&&&&&