A&&&&&&&  &
          &
  && &&&  &
       && &
&& &&&&&  &
B        &&
&&& &&&& &&
          &   
&&&&&&&&&&&