A&&&&&&&  &
   &&&    &
  && &&&  &
          &
& &&&&&& &&
B        &&
&&&&&&&&&&&