&P& &&&&&&
 & &    &&
 &&&&& & &
& &&    L& 
&&&&&&&&&&
&&&&&&&&&&