&&&&&&&&&&&&&&&&
&P& &          &
& & & & &&&&&& &
& & & &        &
& &   &&&& & & &
& & & &&&& &   &
&   &        &L&
& & & &&&&&& & &
& & &        & &
& &   &&&& &   &
& & &      &&&&&
&&&&&&&&&&&&&&&&