&&&&&&&&&&&&&&&& 
& &P& &        &
& & & & &&&&&& &
& & & &        &
& & & &&&& & & &
& & & &&&& &   &
&   &        & &
& & & &&&&&& & & 
& & &        & &
& & & &&&& &   &
& & &      &&&L&
&&&&&&&&&&&&&&&&