&&&&&&&&&&&&&&&& 
& &P&          &
& & & & &&&&&& &
& & & &        &
& & & &&&& & & &
& & & &&&& &   &
&   &        & &
& & & &&&&&& & & 
& & &        & &
& & & &&&& &   &
& &L&      &&&&&
&&&&&&&&&&&&&&&&