&P& &&&&&&
 & &    &&
 && &&&& &
& &&    L& 
&&  &&&&&&
&&&&&&&&&&