&P& &&&&&&
 & &    &&
 &&&&& & &
& &&    L& 
&&  && &&&
&&&&&&&&&&