 P&&&&  &&&
 &       &&
  &&&  & &&
 &      L&&
    && &&&&
&&&&&&&&&&&